---
name: Simple Maze
---
┌──────────────┐
│              │
│              │
├──────────    │
│              │
│              │
│    ──────────┤
│              │
│              │
├──────────    │
│              │
│              │
│    ──────────┤
│              │
│              │
└──────────────┘